{
	"name": "Pallet Town",
	"tileset": "palletTown",
	"width": 31,
	"data": [
		  0,  0,  0,  0,  0,  0,  0,  0,  0,  0,  0,  0,  0,  0,  0,  0,  0,  0,  0,  0,  0,  0,  0,  0,  0,  0,  0,  0,  0,  0,  0,
		  0,  0,  0,  0,  0,  0,  0,  0,  0,  0,  0,  0,  0,  0,  0,  0,  0,  0,  0,  0,  0,  0,  0,  0,  0,  0,  0,  0,  0,  0,  0,  
		  0,  0,  0,  0,  0,  0,  0,  0,  0,  0,  0,  0,  0,  0,  0,  0,  0,  0,  0,  0,  0,  0,  0,  0,  0,  0,  0,  0,  0,  0,  0,  
		  0,  0,  0,  0,  0,  0,  0,  0,  0,  0,  0,  0,  0,  0,  0,  0,  0,  0,  0,  0,  0,  0,  0,  0,  0,  0,  0,  0,  0,  0,  0,  
		  0,  0,  7,  2,  2,  2,  2,  2,  2,  2,  2,  2,  2,  2,  2,  2,  2,  2,  2,  2,  2,  2,  2,  2,  2,  6,  0,  0,  0,  0,  0,  
		  0,  0,  5,  1,  1,  1,  1,  1,  1,  1,  1,  1,  1,  1,  1,  1,  1,  1,  1,  1,  1,  1,  1,  1,  1,  4,  0,  0,  0,  0,  0,  
		  0,  0,  5,  1, 12,  3,  3,  3,  3,  3,  3,  3, 13,  1,  1, 12,  3,  3,  3,  3,  3,  3,  3, 13,  1,  4,  0,  0,  0,  0,  0,  
		  0,  0,  5,  1,  4,  0,  0,  0,  0,  0,  0,  0,  5,  1,  1,  4,  0,  0,  0,  0,  0,  0,  0,  5,  1,  4,  0,  0,  0,  0,  0,  
		  0,  0,  5,  1,  4,  0,  0,  0,  0,  0,  0,  0,  5,  1,  1,  4,  0,  0,  0,  0,  0,  0,  0,  5,  1,  4,  0,  0,  0,  0,  0,  
		  0,  0,  5,  1,  4,  0,  0,  0,  0,  0,  0,  0,  5,  1,  1,  4,  0,  0,  0,  0,  0,  0,  0,  5,  1,  4,  0,  0,  0,  0,  0,  
		  0,  0,  5,  1,  4,  0,  0,  0,  0,  0,  0,  0,  5,  1,  1,  4,  0,  0,  0,  0,  0,  0,  0,  5,  1,  4,  0,  0,  0,  0,  0,  
		  0,  0,  5,  1,  4,  0,  0,  0,  0,  0,  0,  0,  5,  1,  1,  4,  0,  0,  0,  0,  0,  0,  0,  5,  1,  4,  0,  0,  0,  0,  0,  
		  0,  0,  5,  1, 10,  2,  2,  2,  2,  2,  2,  2, 11,  1,  1,  10, 2,  2,  2,  2,  2,  2,  2, 11,  1,  4,  0,  0,  0,  0,  0,  
 			0,  0,  5,  1,  1,  1,  1,  1,  1,  1,  1,  1,  1,  1,  1,  1,  1,  1,  1,  1,  1,  1,  1,  1,  1,  4,  0,  0,  0,  0,  0,  
		  0,  0,  5,  1, 12,  3,  3,  3,  3,  3,  3,  3, 13,  1,  1, 12,  3,  3,  3,  3,  3,  3,  3, 13,  1,  4,  0,  0,  0,  0,  0,  
		  0,  0,  5,  1,  4,  0,  0,  0,  0,  0,  0,  0,  5,  1,  1,  4,  0,  0,  0,  0,  0,  0,  0,  5,  1,  4,  0,  0,  0,  0,  0,  
		  0,  0,  5,  1,  4,  0,  0,  0,  0,  0,  0,  0,  5,  1,  1,  4,  0,  0,  0,  0,  0,  0,  0,  5,  1,  4,  0,  0,  0,  0,  0,  
		  0,  0,  5,  1,  4,  0,  0,  0,  0,  0,  0,  0,  5,  1,  1,  4,  0,  0,  0,  0,  0,  0,  0,  5,  1,  4,  0,  0,  0,  0,  0,  
		  0,  0,  5,  1,  4,  0,  0,  0,  0,  0,  0,  0,  5,  1,  1,  4,  0,  0,  0,  0,  0,  0,  0,  5,  1,  4,  0,  0,  0,  0,  0,  
		  0,  0,  5,  1,  4,  0,  0,  0,  0,  0,  0,  0,  5,  1,  1,  4,  0,  0,  0,  0,  0,  0,  0,  5,  1,  4,  0,  0,  0,  0,  0,  
		  0,  0,  5,  1, 10,  2,  2,  2,  2,  2,  2,  2, 11,  1,  1,  10, 2,  2,  2,  2,  2,  2,  2, 11,  1,  4,  0,  0,  0,  0,  0,  
		  0,  0,  0,  0,  0,  0,  0,  0,  0,  0,  0,  0,  0,  0,  0,  0,  0,  0,  0,  0,  0,  0,  0,  0,  0,  0,  0,  0,  0,  0,  0,  
		  0,  0,  0,  0,  0,  0,  0,  0,  0,  0,  0,  0,  0,  0,  0,  0,  0,  0,  0,  0,  0,  0,  0,  0,  0,  0,  0,  0,  0,  0,  0,
		  0,  0,  0,  0,  0,  0,  0,  0,  0,  0,  0,  0,  0,  0,  0,  0,  0,  0,  0,  0,  0,  0,  0,  0,  0,  0,  0,  0,  0,  0,  0,  
		  0,  0,  0,  0,  0,  0,  0,  0,  0,  0,  0,  0,  0,  0,  0,  0,  0,  0,  0,  0,  0,  0,  0,  0,  0,  0,  0,  0,  0,  0,  0,  
		  0,  0,  0,  0,  0,  0,  0,  0,  0,  0,  0,  0,  0,  0,  0,  0,  0,  0,  0,  0,  0,  0,  0,  0,  0,  0,  0,  0,  0,  0,  0,  
		  0,  0,  0,  0,  0,  0,  0,  0,  0,  0,  0,  0,  0,  0,  0,  0,  0,  0,  0,  0,  0,  0,  0,  0,  0,  0,  0,  0,  0,  0,  0,  
		  0,  0,  0,  0,  0,  0,  0,  0,  0,  0,  0,  0,  0,  0,  0,  0,  0,  0,  0,  0,  0,  0,  0,  0,  0,  0,  0,  0,  0,  0,  0,  
		  0,  0,  0,  0,  0,  0,  0,  0,  0,  0,  0,  0,  0,  0,  0,  0,  0,  0,  0,  0,  0,  0,  0,  0,  0,  0,  0,  0,  0,  0,  0,  
		  0,  0,  0,  0,  0,  0,  0,  0,  0,  0,  0,  0,  0,  0,  0,  0,  0,  0,  0,  0,  0,  0,  0,  0,  0,  0,  0,  0,  0,  0,  0,  
		  0,  0,  0,  0,  0,  0,  0,  0,  0,  0,  0,  0,  0,  0,  0,  0,  0,  0,  0,  0,  0,  0,  0,  0,  0,  0,  0,  0,  0,  0,  0],
	"dummyTile": 0,
	"staticMapEntities": {
		"trainer": {
			"sprite": "trainer",
			"center": {
				"x": 51,
				"y": 124
			},
			"collisionWidth": 1,
			"collisionHeight": 1,
			"isRounded": true
		},
		"house": {
			"sprite": "house",
			"center": {
				"x": 283,
				"y": 514
			},
			"collisionWidth": 6,
			"collisionHeight": 3,
			"isRounded": false
		},
		"mailBox": {
			"sprite": "mailBox",
			"center": {
				"x": 42,
				"y": 124
			},
			"collisionWidth": 1,
			"collisionHeight": 1,
			"isRounded": false,
			"x": 5.5,
			"y": 11
		}
	},
	"staticMapInstances": [
		{
			"entity": "trainer",
			"x": 0,
			"y": 0
		}, {
			"entity": "house",
			"x": 8.5,
			"y": 10
		}, {
			"entity": "house",
			"x": 19.5,
			"y": 10
		}, {
			"entity": "mailBox",
			"x": 5.5,
			"y": 10.99
		}, {
			"entity": "mailBox",
			"x": 16.5,
			"y": 10.99
		}
	],
	"npcs": [
		{
			"id": "block",
			"x": 1,
			"y": 1,
			"startingDirection": "down"
		}
	],
	"tracks": ["marioLuigiBattle"]
}