{
	"name": "Pallet Town",
	"tileset": "palletTown",
	"width": 31,
	"data": [
		  0,  0,  0,  0,  0,  0,  0,  0,  0,  0,  0,  0,  0,  0,  0,  0,  0,  0,  0,  0,  0,  0,  0,  0,  0,  0,  0,  0,  0,  0,  0,
		  0,  0,  0,  0,  0,  0,  0,  0,  0,  0,  0,  0,  0,  0,  0,  0,  0,  0,  0,  0,  0,  0,  0,  0,  0,  0,  0,  0,  0,  0,  0,  
		  0,  0,  0,  0,  0,  0,  0,  0,  0,  0,  0,  0,  0,  0,  0,  0,  0,  0,  0,  0,  0,  0,  0,  0,  0,  0,  0,  0,  0,  0,  0,  
		  0,  0,  0,  0,  0,  0,  0,  0,  0,  0,  0,  0,  0,  0,  0,  0,  0,  0,  0,  0,  0,  0,  0,  0,  0,  0,  0,  0,  0,  0,  0,  
		  0,  0,  7,  2,  2,  2,  2,  2,  2,  2,  2,  2,  2,  2,  2,  2,  2,  2,  2,  2,  2,  2,  2,  2,  2,  6,  0,  0,  0,  0,  0,  
		  0,  0,  5,  1,  1,  1,  1,  1,  1,  1,  1,  1,  1,  1,  1,  1,  1,  1,  1,  1,  1,  1,  1,  1,  1,  4,  0,  0,  0,  0,  0,  
		  0,  0,  5,  1, 12,  3,  3,  3,  3,  3,  3,  3, 13,  1,  1, 12,  3,  3,  3,  3,  3,  3,  3, 13,  1,  4,  0,  0,  0,  0,  0,  
		  0,  0,  5,  1,  4,  0,  0,  0,  0,  0,  0,  0,  5,  1,  1,  4,  0,  0,  0,  0,  0,  0,  0,  5,  1,  4,  0,  0,  0,  0,  0,  
		  0,  0,  5,  1,  4,  0,  0,  0,  0,  0,  0,  0,  5,  1,  1,  4,  0,  0,  0,  0,  0,  0,  0,  5,  1,  4,  0,  0,  0,  0,  0,  
		  0,  0,  5,  1,  4,  0,  0,  0,  0,  0,  0,  0,  5,  1,  1,  4,  0,  0,  0,  0,  0,  0,  0,  5,  1,  4,  0,  0,  0,  0,  0,  
		  0,  0,  5,  1,  4,  0,  0,  0,  0,  0,  0,  0,  5,  1,  1,  4,  0,  0,  0,  0,  0,  0,  0,  5,  1,  4,  0,  0,  0,  0,  0,  
		  0,  0,  5,  1,  4,  0,  0,  0,  0,  0,  0,  0,  5,  1,  1,  4,  0,  0,  0,  0,  0,  0,  0,  5,  1,  4,  0,  0,  0,  0,  0,  
		  0,  0,  5,  1, 10,  2,  2,  2,  2,  2,  2,  2, 11,  1,  1,  10, 2,  2,  2,  2,  2,  2,  2, 11,  1,  4,  0,  0,  0,  0,  0,  
 			0,  0,  5,  1,  1,  1,  1,  1,  1,  1,  1,  1,  1,  1,  1,  1,  1,  1,  1,  1,  1,  1,  1,  1,  1,  4,  0,  0,  0,  0,  0,  
		  0,  0,  5,  1, 12,  3,  3,  3,  3,  3,  3,  3, 13,  1,  1, 12,  3,  3,  3,  3,  3,  3,  3, 13,  1,  4,  0,  0,  0,  0,  0,  
		  0,  0,  5,  1,  4,  0,  0,  0,  0,  0,  0,  0,  5,  1,  1,  4,  0,  0,  0,  0,  0,  0,  0,  5,  1,  4,  0,  0,  0,  0,  0,  
		  0,  0,  5,  1,  4,  0,  0,  0,  0,  0,  0,  0,  5,  1,  1,  4,  0,  0,  0,  0,  0,  0,  0,  5,  1,  4,  0,  0,  0,  0,  0,  
		  0,  0,  5,  1,  4,  0,  0,  0,  0,  0,  0,  0,  5,  1,  1,  4,  0,  0,  0,  0,  0,  0,  0,  5,  1,  4,  0,  0,  0,  0,  0,  
		  0,  0,  5,  1,  4,  0,  0,  0,  0,  0,  0,  0,  5,  1,  1,  4,  0,  0,  0,  0,  0,  0,  0,  5,  1,  4,  0,  0,  0,  0,  0,  
		  0,  0,  5,  1,  4,  0,  0,  0,  0,  0,  0,  0,  5,  1,  1,  4,  0,  0,  0,  0,  0,  0,  0,  5,  1,  4,  0,  0,  0,  0,  0,  
		  0,  0,  5,  1, 10,  2,  2,  2,  2,  2,  2,  2, 11,  1,  1,  10, 2,  2,  2,  2,  2,  2,  2, 11,  1,  4,  0,  0,  0,  0,  0,  
		  0,  0,  0,  0,  0,  0,  0,  0,  0,  0,  0,  0,  0,  0,  0,  0,  0,  0,  0,  0,  0,  0,  0,  0,  0,  0,  0,  0,  0,  0,  0,  
		  0,  0,  0,  0,  0,  0,  0,  0,  0,  0,  0,  0,  0,  0,  0,  0,  0,  0,  0,  0,  0,  0,  0,  0,  0,  0,  0,  0,  0,  0,  0,
		  0,  0,  0,  0,  0,  0,  0,  0,  0,  0,  0,  0,  0,  0,  0,  0,  0,  0,  0,  0,  0,  0,  0,  0,  0,  0,  0,  0,  0,  0,  0,  
		  0,  0,  0,  0,  0,  0,  0,  0,  0,  0,  0,  0,  0,  0,  0,  0,  0,  0,  0,  0,  0,  0,  0,  0,  0,  0,  0,  0,  0,  0,  0,  
		  0,  0,  0,  0,  0,  0,  0,  0,  0,  0,  0,  0,  0,  0,  0,  0,  0,  0,  0,  0,  0,  0,  0,  0,  0,  0,  0,  0,  0,  0,  0,  
		  0,  0,  0,  0,  0,  0,  0,  0,  0,  0,  0,  0,  0,  0,  0,  0,  0,  0,  0,  0,  0,  0,  0,  0,  0,  0,  0,  0,  0,  0,  0,  
		  0,  0,  0,  0,  0,  0,  0,  0,  0,  0,  0,  0,  0,  0,  0,  0,  0,  0,  0,  0,  0,  0,  0,  0,  0,  0,  0,  0,  0,  0,  0,  
		  0,  0,  0,  0,  0,  0,  0,  0,  0,  0,  0,  0,  0,  0,  0,  0,  0,  0,  0,  0,  0,  0,  0,  0,  0,  0,  0,  0,  0,  0,  0,  
		  0,  0,  0,  0,  0,  0,  0,  0,  0,  0,  0,  0,  0,  0,  0,  0,  0,  0,  0,  0,  0,  0,  0,  0,  0,  0,  0,  0,  0,  0,  0,  
		  0,  0,  0,  0,  0,  0,  0,  0,  0,  0,  0,  0,  0,  0,  0,  0,  0,  0,  0,  0,  0,  0,  0,  0,  0,  0,  0,  0,  0,  0,  0],
	"dummyTile": 0,
	"staticMapEntities": {
		"trainer": {
			"sprite": "trainer",
			"edge": {
				"x": 51,
				"y": 168
			},
			"collisionWidth": 1,
			"collisionHeight": 1,
			"isRounded": true
		},
		"house": {
			"sprite": "house",
			"edge": {
				"x": 283,
				"y": 668
			},
			"collisionWidth": 6,
			"collisionHeight": 3,
			"isRounded": false
		},
		"mailBox": {
			"sprite": "mailBox",
			"edge": {
				"x": 42,
				"y": 156
			},
			"collisionWidth": 1,
			"collisionHeight": 1,
			"isRounded": false,
			"x": 5.5,
			"y": 11
		}
	},
	"staticMapInstances": [
		{
			"entity": "trainer",
			"x": 1,
			"y": 1
		}, {
			"entity": "house",
			"x": 8.5,
			"y": 10
		}, {
			"entity": "house",
			"x": 19.5,
			"y": 10
		}, {
			"entity": "mailBox",
			"x": 5.5,
			"y": 10.99
		}, {
			"entity": "mailBox",
			"x": 16.5,
			"y": 10.99
		}
	],
	"npcs": [
		{
			"entityId": "block",
			"id": "block01",
			"x": 2,
			"y": 2,
			"startingDirection": "down"
		}
	],
	"tracks": ["marioLuigiBattle"],
	"spawnBehavior": {
		"monsterData": {
			"ball": {
				"capacity": 10,
				"spawnInterval": 1800,
				"spawnRate": 1,
				"spawnPoints": [0]
			}
		},
		"spawnPoints": [
			{
				"x": 20,
				"y": 0,
				"width": 10,
				"height": 10
			}
		]
	},
	"events": [
		{
			"id": "warpTile",
			"variableData": {
				"set": false
			},
			"states": [
				{
					"condition": "
						this.set && ConditionHelper.playerInRectZone(this, 7, 11.5, 
								1, 1) && this.containingMap.player.getDirection() == 
										Direction.UP;
					",
					"body": "
						this.set = false;
						InputRouter.setMode(InputRouter.Modes.DISABLED);
						var player = this.containingMap.player;
						player.setIdle();
						EventHelper.switchMap(this, 'palletTown', 0.5, 10, function() {
							InputRouter.setMode(InputRouter.Modes.PLAYER_MAP_MOVEMENT);
						});
					"
				}, {
					"condition": "
						!this.set && !ConditionHelper.playerInRectZone(this, 7, 11.5, 
								1, 1);
					",
					"body": "
						this.set = true;
					"
				}
			]
		}
	]
}