{
	"name": "Pallet Town",
	"tileset": "palletTown",
	"width": 31,
	"data": [
		  0,  0,  0,  0,  0,  0,  0,  0,  0,  0,  0,  0,  0,  0,  0,  0,  0,  0,  0,  0,  0,  0,  0,  0,  0,  0,  0,  0,  0,  0,  0,
		  0,  0,  0,  0,  0,  0,  0,  0,  0,  0,  0,  0,  0,  0,  0,  0,  0,  0,  0,  0,  0,  0,  0,  0,  0,  0,  0,  0,  0,  0,  0,  
		  0,  0,  0,  0,  0,  0,  0,  0,  0,  0,  0,  0,  0,  0,  0,  0,  0,  0,  0,  0,  0,  0,  0,  0,  0,  0,  0,  0,  0,  0,  0,  
		  0,  0,  0,  0,  0,  0,  0,  0,  0,  0,  0,  0,  0,  0,  0,  0,  0,  0,  0,  0,  0,  0,  0,  0,  0,  0,  0,  0,  0,  0,  0,  
		  0,  0,  7,  2,  2,  2,  2,  2,  2,  2,  2,  2,  2,  2,  2,  2,  2,  2,  2,  2,  2,  2,  2,  2,  2,  6,  0,  0,  0,  0,  0,  
		  0,  0,  5,  1,  1,  1,  1,  1,  1,  1,  1,  1,  1,  1,  1,  1,  1,  1,  1,  1,  1,  1,  1,  1,  1,  4,  0,  0,  0,  0,  0,  
		  0,  0,  5,  1, 12,  3,  3,  3,  3,  3,  3,  3, 13,  1,  1, 12,  3,  3,  3,  3,  3,  3,  3, 13,  1,  4,  0,  0,  0,  0,  0,  
		  0,  0,  5,  1,  4,  0,  0,  0,  0,  0,  0,  0,  5,  1,  1,  4,  0,  0,  0,  0,  0,  0,  0,  5,  1,  4,  0,  0,  0,  0,  0,  
		  0,  0,  5,  1,  4,  0,  0,  0,  0,  0,  0,  0,  5,  1,  1,  4,  0,  0,  0,  0,  0,  0,  0,  5,  1,  4,  0,  0,  0,  0,  0,  
		  0,  0,  5,  1,  4,  0,  0,  0,  0,  0,  0,  0,  5,  1,  1,  4,  0,  0,  0,  0,  0,  0,  0,  5,  1,  4,  0,  0,  0,  0,  0,  
		  0,  0,  5,  1,  4,  0,  0,  0,  0,  0,  0,  0,  5,  1,  1,  4,  0,  0,  0,  0,  0,  0,  0,  5,  1,  4,  0,  0,  0,  0,  0,  
		  0,  0,  5,  1,  4,  0,  0,  0,  0,  0,  0,  0,  5,  1,  1,  4,  0,  0,  0,  0,  0,  0,  0,  5,  1,  4,  0,  0,  0,  0,  0,  
		  0,  0,  5,  1, 10,  2,  2,  2,  2,  2,  2,  2, 11,  1,  1,  10, 2,  2,  2,  2,  2,  2,  2, 11,  1,  4,  0,  0,  0,  0,  0,  
 			0,  0,  5,  1,  1,  1,  1,  1,  1,  1,  1,  1,  1,  1,  1,  1,  1,  1,  1,  1,  1,  1,  1,  1,  1,  4,  0,  0,  0,  0,  0,  
		  0,  0,  5,  1, 12,  3,  3,  3,  3,  3,  3,  3, 13,  1,  1, 12,  3,  3,  3,  3,  3,  3,  3, 13,  1,  4,  0,  0,  0,  0,  0,  
		  0,  0,  5,  1,  4,  0,  0,  0,  0,  0,  0,  0,  5,  1,  1,  4,  0,  0,  0,  0,  0,  0,  0,  5,  1,  4,  0,  0,  0,  0,  0,  
		  0,  0,  5,  1,  4,  0,  0,  0,  0,  0,  0,  0,  5,  1,  1,  4,  0,  0,  0,  0,  0,  0,  0,  5,  1,  4,  0,  0,  0,  0,  0,  
		  0,  0,  5,  1,  4,  0,  0,  0,  0,  0,  0,  0,  5,  1,  1,  4,  0,  0,  0,  0,  0,  0,  0,  5,  1,  4,  0,  0,  0,  0,  0,  
		  0,  0,  5,  1,  4,  0,  0,  0,  0,  0,  0,  0,  5,  1,  1,  4,  0,  0,  0,  0,  0,  0,  0,  5,  1,  4,  0,  0,  0,  0,  0,  
		  0,  0,  5,  1,  4,  0,  0,  0,  0,  0,  0,  0,  5,  1,  1,  4,  0,  0,  0,  0,  0,  0,  0,  5,  1,  4,  0,  0,  0,  0,  0,  
		  0,  0,  5,  1, 10,  2,  2,  2,  2,  2,  2,  2, 11,  1,  1,  10, 2,  2,  2,  2,  2,  2,  2, 11,  1,  4,  0,  0,  0,  0,  0,  
		  0,  0,  0,  0,  0,  0,  0,  0,  0,  0,  0,  0,  0,  0,  0,  0,  0,  0,  0,  0,  0,  0,  0,  0,  0,  0,  0,  0,  0,  0,  0,  
		  0,  0,  0,  0,  0,  0,  0,  0,  0,  0,  0,  0,  0,  0,  0,  0,  0,  0,  0,  0,  0,  0,  0,  0,  0,  0,  0,  0,  0,  0,  0,
		  0,  0,  0,  0,  0,  0,  0,  0,  0,  0,  0,  0,  0,  0,  0,  0,  0,  0,  0,  0,  0,  0,  0,  0,  0,  0,  0,  0,  0,  0,  0,  
		  0,  0,  0,  0,  0,  0,  0,  0,  0,  0,  0,  0,  0,  0,  0,  0,  0,  0,  0,  0,  0,  0,  0,  0,  0,  0,  0,  0,  0,  0,  0,  
		  0,  0,  0,  0,  0,  0,  0,  0,  0,  0,  0,  0,  0,  0,  0,  0,  0,  0,  0,  0,  0,  0,  0,  0,  0,  0,  0,  0,  0,  0,  0,  
		  0,  0,  0,  0,  0,  0,  0,  0,  0,  0,  0,  0,  0,  0,  0,  0,  0,  0,  0,  0,  0,  0,  0,  0,  0,  0,  0,  0,  0,  0,  0,  
		  0,  0,  0,  0,  0,  0,  0,  0,  0,  0,  0,  0,  0,  0,  0,  0,  0,  0,  0,  0,  0,  0,  0,  0,  0,  0,  0,  0,  0,  0,  0,  
		  0,  0,  0,  0,  0,  0,  0,  0,  0,  0,  0,  0,  0,  0,  0,  0,  0,  0,  0,  0,  0,  0,  0,  0,  0,  0,  0,  0,  0,  0,  0,  
		  0,  0,  0,  0,  0,  0,  0,  0,  0,  0,  0,  0,  0,  0,  0,  0,  0,  0,  0,  0,  0,  0,  0,  0,  0,  0,  0,  0,  0,  0,  0,  
		  0,  0,  0,  0,  0,  0,  0,  0,  0,  0,  0,  0,  0,  0,  0,  0,  0,  0,  0,  0,  0,  0,  0,  0,  0,  0,  0,  0,  0,  0,  0],
	"dummyTile": 0,
	"staticMapEntities": [
		{
			"sprite": "trainer",
			"x": 0,
			"y": 0
		},
		{
			"sprite": "mailBox",
			"x": 5.5,
			"y": 10.5
		},
		{
			"sprite": "mailBox",
			"x": 16.5,
			"y": 10.5
		},
		{
			"sprite": "house",
			"x": 8.5,
			"y": 8
		},
		{
			"sprite": "house",
			"x": 19.5,
			"y": 8
		},
		{
			"sprite": "fence",
			"x": 6.5,
			"y": 16.5
		},
		{
			"sprite": "fence",
			"x": 7.5,
			"y": 16.5
		},
		{
			"sprite": "fence",
			"x": 8.5,
			"y": 16.5
		},
		{
			"sprite": "fence",
			"x": 9.5,
			"y": 16.5
		},
		{
			"sprite": "tree",
			"x": 11,
			"y": 2.5
		},
		{
			"sprite": "tree",
			"x": 9,
			"y": 2.5
		},
		{
			"sprite": "tree",
			"x": 7,
			"y": 2.5
		},
		{
			"sprite": "tree",
			"x": 5,
			"y": 2.5
		},
		{
			"sprite": "tree",
			"x": 3,
			"y": 2.5
		},
		{
			"sprite": "tree",
			"x": 1,
			"y": 2.5
		}
	

	]
}