{
	"name": "Test Map",
	"tileset": "test",
	"width": 25,
	"data": [
		  11,   11,   11,   11,   11,   11,   11,   11,   11,   11,   11,   11,   11,   11,   11,   11,   11,   11,   11,   11,   11,   11,   11,   11,   11, 
		  11,   11,   11,   11,   11,   11,   11,   11,   11,   11,   11,   11,   11,   11,   11,   11,   11,   11,   11,   11,   11,   11,   11,   11,   11, 
		  11,   11,   11,   11,   11,   11,   11,   11,   11,   11,   11,   11,   11,   11,   11,   11,   11,   11,   11,   11,   11,   11,   11,   11,   11, 
		  11,   11,   11,   11,   11,   11,   11,   11,   11,   11,   11,   11,   11,   11,   11,   11,   11,   11,   11,   11,   11,   11,   11,   11,   11, 
		  11,   11,   11,   11,   11,   11,   11,   11,   11,   11,   11,   11,   11,   11,   11,   11,   11,   11,   11,   11,   11,   11,   11,   11,   11, 
		  11,   11,   11,   11,   11,   11,   11,   11,   11,   11,   11,   11,   11,   11,   11,   11,   11,   11,   11,   11,   11,   11,   11,   11,   11, 
		  11,   11,   11,   11,   11,   11,   11,   11,   11,   11,   11,   11,   11,   11,   11,   11,   11,   11,   11,   11,   11,   11,   11,   11,   11, 
		  11,   11,   11,   11,   11,   11,   11,   11,   11,   11,   11,   11,   11,   11,   11,   11,   11,   11,   11,   11,   11,   11,   11,   11,   11, 
		  11,   11,   11,   11,   11,   11,   11,   11,   11,    7,    3,    3,    3,    8,   11,   11,   11,   11,   11,   11,   11,   11,   11,   11,   11, 
		  11,   11,   11,   11,   11,   11,   11,   11,    7,   14,    2,    2,    2,   15,    8,   11,   11,   11,   11,   11,   11,   11,   11,   11,   11, 
		  11,   11,   11,   11,   11,   11,   11,   11,    6,    2,    2,    2,    2,    2,    4,   11,   11,   11,   11,   11,   11,   11,   11,   11,   11, 
		  11,   11,   11,   11,   11,   11,   11,   11,    6,    2,    2,    2,    2,    2,    4,   11,   11,   11,   11,   11,   11,   11,   11,   11,   11, 
		  11,   11,   11,   11,   11,   11,   11,   11,   10,   13,    2,    2,    2,   12,    9,   11,   11,   11,   11,   11,   11,   11,   11,   11,   11, 
		  11,   11,   11,   11,   11,   11,   11,   11,   11,   10,    5,    5,    5,    9,   11,   11,   11,   11,   11,   11,   11,   11,   11,   11,   11, 
		  11,   11,   11,   11,   11,   11,   11,   11,   11,   11,   11,   11,   11,   11,   11,   11,   11,   11,   11,   11,   11,   11,   11,   11,   11, 
		  11,   11,   11,   11,   11,   11,   11,   11,   11,   11,   11,   11,   11,   11,   11,   11,   11,   11,   11,   11,   11,   11,   11,   11,   11, 
		  11,   11,   11,   11,   11,   11,   11,   11,   11,   11,   11,   11,   11,   11,   11,   11,   11,   11,   11,   11,   11,   11,   11,   11,   11, 
		  11,   11,   11,   11,   11,   11,   11,   11,   11,   11,   11,   11,   11,   11,   11,   11,   11,   11,   11,   11,   11,   11,   11,   11,   11, 
		  11,   11,   11,   11,   11,   11,   11,   11,   11,   11,   11,   11,   11,   11,   11,   11,   11,   11,   11,   11,   11,   11,   11,   11,   11, 
		  11,   11,   11,   11,   11,   11,   11,   11,   11,   11,   11,   11,   11,   11,   11,   11,   11,   11,   11,   11,   11,   11,   11,   11,   11, 
		  11,   11,   11,   11,   11,   11,   11,   11,   11,   11,   11,   11,   11,   11,   11,   11,   11,   11,   11,   11,   11,   11,   11,   11,   11, 
		  11,   11,   11,   11,   11,   11,   11,   11,   11,   11,   11,   11,   11,   11,   11,   11,   11,   11,   11,   11,   11,   11,   11,   11,   11, 
		  11,   11,   11,   11,   11,   11,   11,   11,   11,   11,   11,   11,   11,   11,   11,   11,   11,   11,   11,   11,   11,   11,   11,   11,   11, 
		  11,   11,   11,   11,   11,   11,   11,   11,   11,   11,   11,   11,   11,   11,   11,   11,   11,   11,   11,   11,   11,   11,   11,   11,   11, 
		  11,   11,   11,   11,   11,   11,   11,   11,   11,   11,   11,   11,   11,   11,   11,   11,   11,   11,   11,   11,   11,   11,   11,   11,   11],
	"dummyTile": 0,
	"staticMapEntities": [
		{
			"sprite": "trainer",
			"x": 0,
			"y": 0
		}
	]
}